C:\Programs\Coding\Git>openssl -version
Invalid command '-version'; type "help" for a list.

C:\Programs\Coding\Git>openssl help
Standard commands
asn1parse         ca                ciphers           cms
crl               crl2pkcs7         dgst              dhparam
dsa               dsaparam          ec                ecparam
enc               engine            errstr            gendsa
genpkey           genrsa            help              list
nseq              ocsp              passwd            pkcs12
pkcs7             pkcs8             pkey              pkeyparam
pkeyutl           prime             rand              rehash
req               rsa               rsautl            s_client
s_server          s_time            sess_id           smime
speed             spkac             srp               storeutl
ts                verify            version           x509

Message Digest commands (see the `dgst' command for more details)
blake2b512        blake2s256        gost              md4
md5               mdc2              rmd160            sha1
sha224            sha256            sha3-224          sha3-256
sha3-384          sha3-512          sha384            sha512
sha512-224        sha512-256        shake128          shake256
sm3

Cipher commands (see the `enc' command for more details)
aes-128-cbc       aes-128-ecb       aes-192-cbc       aes-192-ecb
aes-256-cbc       aes-256-ecb       aria-128-cbc      aria-128-cfb
aria-128-cfb1     aria-128-cfb8     aria-128-ctr      aria-128-ecb
aria-128-ofb      aria-192-cbc      aria-192-cfb      aria-192-cfb1
aria-192-cfb8     aria-192-ctr      aria-192-ecb      aria-192-ofb
aria-256-cbc      aria-256-cfb      aria-256-cfb1     aria-256-cfb8
aria-256-ctr      aria-256-ecb      aria-256-ofb      base64
bf                bf-cbc            bf-cfb            bf-ecb
bf-ofb            camellia-128-cbc  camellia-128-ecb  camellia-192-cbc
camellia-192-ecb  camellia-256-cbc  camellia-256-ecb  cast
cast-cbc          cast5-cbc         cast5-cfb         cast5-ecb
cast5-ofb         des               des-cbc           des-cfb
des-ecb           des-ede           des-ede-cbc       des-ede-cfb
des-ede-ofb       des-ede3          des-ede3-cbc      des-ede3-cfb
des-ede3-ofb      des-ofb           des3              desx
idea              idea-cbc          idea-cfb          idea-ecb
idea-ofb          rc2               rc2-40-cbc        rc2-64-cbc
rc2-cbc           rc2-cfb           rc2-ecb           rc2-ofb
rc4               rc4-40            rc5               rc5-cbc
rc5-cfb           rc5-ecb           rc5-ofb           seed
seed-cbc          seed-cfb          seed-ecb          seed-ofb
sm4-cbc           sm4-cfb           sm4-ctr           sm4-ecb
sm4-ofb           zlib


C:\Programs\Coding\Git>openssl rsa -help
Usage: rsa [options]
Valid options are:
 -help              Display this summary
 -inform format     Input format, one of DER PEM
 -outform format    Output format, one of DER PEM PVK
 -in val            Input file
 -out outfile       Output file
 -pubin             Expect a public key in input file
 -pubout            Output a public key
 -passout val       Output file pass phrase source
 -passin val        Input file pass phrase source
 -RSAPublicKey_in   Input is an RSAPublicKey
 -RSAPublicKey_out  Output is an RSAPublicKey
 -noout             Don't print key out
 -text              Print the key in text
 -modulus           Print the RSA key modulus
 -check             Verify key consistency
 -*                 Any supported cipher
 -pvk-strong        Enable 'Strong' PVK encoding level (default)
 -pvk-weak          Enable 'Weak' PVK encoding level
 -pvk-none          Don't enforce PVK encoding
 -engine val        Use engine, possibly a hardware device

C:\Programs\Coding\Git>openssl genpkey -algorithm RSA -out mi_clave_privada.pem -pkeyopt rsa_keygen_bits:2048
................+++++
..................................................................................................................................................+++++

C:\Programs\Coding\Git>cd D
The system cannot find the path specified.

C:\Programs\Coding\Git>D
'D' is not recognized as an internal or external command,
operable program or batch file.

C:\Programs\Coding\Git>cd "UVG/System Security"
The system cannot find the path specified.

C:\Programs\Coding\Git>cd UVG
The system cannot find the path specified.

C:\Programs\Coding\Git>D:

D:\>cd "UVG/System Security"

D:\UVG\System Security>openssl genpkey -algorithm RSA -out mi_clave_privada.pem -pkeyopt rsa_keygen_bits:2048
..+++++
..............................+++++

D:\UVG\System Security>openssl rsa -in mi_clave_privada.pem -pubout -out mi_clave_publica.pem
writing RSA key

D:\UVG\System Security>openssl rand -base64 32  aes_key.txt
Extra arguments given.
rand: Use -help for summary.

D:\UVG\System Security>openssl rand -base64 32 aes_key.txt
Extra arguments given.
rand: Use -help for summary.

D:\UVG\System Security>openssl rand -base64 32 -out aes_key.txt
Extra arguments given.
rand: Use -help for summary.

D:\UVG\System Security>openssl rand -help
Usage: rand [flags] num
Valid options are:
 -help               Display this summary
 -out outfile        Output file
 -rand val           Load the file(s) into the random number generator
 -writerand outfile  Write random data to the specified file
 -base64             Base64 encode output
 -hex                Hex encode output
 -engine val         Use engine, possibly a hardware device

D:\UVG\System Security>openssl rand -base64 -out aes_key.txt

D:\UVG\System Security>openssl rand 32 -base64 -out aes_key.txt
Extra arguments given.
rand: Use -help for summary.

D:\UVG\System Security>openssl rand -base64 -out aes_key.txt 32

D:\UVG\System Security>openssl enc -aes-256-cbc -salt -in mensaje.txt -out mensaje_cifrado.bin -pas
enc: Unrecognized flag pas
enc: Use -help for summary.

D:\UVG\System Security>openssl enc -aes-256-cbc -salt -in mensaje.txt -out mensaje_cifrado.bin -pass file:aes_key.txt
Can't open mensaje.txt for reading, No such file or directory
40136:error:02001002:system library:fopen:No such file or directory:../openssl-1.1.1s/crypto/bio/bss_file.c:69:fopen('mensaje.txt','rb')
40136:error:2006D080:BIO routines:BIO_new_file:no such file:../openssl-1.1.1s/crypto/bio/bss_file.c:76:

D:\UVG\System Security>openssl enc -aes-256-cbc -salt -in mensaje_aes.txt -out mensaje_cifrado.bin -pass file:aes_key.txt
*** WARNING : deprecated key derivation used.
Using -iter or -pbkdf2 would be better.

D:\UVG\System Security>openssl rsautl -encrypt -inkey clave_publica_destinatario.pem -pubin -in aes_
Can't open clave_publica_destinatario.pem for reading, No such file or directory
37456:error:02001002:system library:fopen:No such file or directory:../openssl-1.1.1s/crypto/bio/bss_file.c:69:fopen('clave_publica_destinatario.pem','r')
37456:error:2006D080:BIO routines:BIO_new_file:no such file:../openssl-1.1.1s/crypto/bio/bss_file.c:76:
unable to load Public Key

D:\UVG\System Security>openssl rsautl -encrypt -inkey clave_publica_destinatario.pem -pubin -in aes_key.txt -out aes_key_cifrada.bin
Can't open clave_publica_destinatario.pem for reading, No such file or directory
10992:error:02001002:system library:fopen:No such file or directory:../openssl-1.1.1s/crypto/bio/bss_file.c:69:fopen('clave_publica_destinatario.pem','r')
10992:error:2006D080:BIO routines:BIO_new_file:no such file:../openssl-1.1.1s/crypto/bio/bss_file.c:76:
unable to load Public Key

D:\UVG\System Security>openssl rsautl -encrypt -inkey clave_publica_destinatario.pem -pubin -in aes_key.txt -out aes_key_cifrada.bin
Can't open clave_publica_destinatario.pem for reading, No such file or directory
26936:error:02001002:system library:fopen:No such file or directory:../openssl-1.1.1s/crypto/bio/bss_file.c:69:fopen('clave_publica_destinatario.pem','r')
26936:error:2006D080:BIO routines:BIO_new_file:no such file:../openssl-1.1.1s/crypto/bio/bss_file.c:76:
unable to load Public Key

D:\UVG\System Security>openssl rsautl -encrypt -inkey rsa_publica_.pem -pubin -in aes_key.txt -out aes_key_cifrada.bin
Can't open rsa_publica_.pem for reading, No such file or directory
22600:error:02001002:system library:fopen:No such file or directory:../openssl-1.1.1s/crypto/bio/bss_file.c:69:fopen('rsa_publica_.pem','r')
22600:error:2006D080:BIO routines:BIO_new_file:no such file:../openssl-1.1.1s/crypto/bio/bss_file.c:76:
unable to load Public Key

D:\UVG\System Security>openssl rsautl -encrypt -inkey rsa_publica.pem -pubin -in aes_key.txt -out aes_key_cifrada.bin

D:\UVG\System Security>openssl rsautl -decrypt -inkey mi_clave_privada.pem -in aes_key_cifrada.bin -
rsautl: Option unknown option -
rsautl: Use -help for summary.

D:\UVG\System Security>openssl rsautl -decrypt -inkey mi_clave_privada.pem -in aes_key_cifrada.bin -openssl rsautl -decrypt -inkey mi_clave_privada.pem -in aes_key_cifrada.bin -
rsautl: Option unknown option -openssl
rsautl: Use -help for summary.

D:\UVG\System Security>openssl rsautl -decrypt -inkey rsa_privada.pem -in aes_key_cifrada_astrid.bin -out aes_key_astrid_descifrada.txt
RSA operation error
8372:error:0407109F:rsa routines:RSA_padding_check_PKCS1_type_2:pkcs decoding error:../openssl-1.1.1s/crypto/rsa/rsa_pk1.c:251:
8372:error:04065072:rsa routines:rsa_ossl_private_decrypt:padding check failed:../openssl-1.1.1s/crypto/rsa/rsa_ossl.c:491:

D:\UVG\System Security>openssl rsautl -decrypt -inkey rsa_privada.pem -in aes_key_cifrada.bin -out aes_key_descifrada.txt

D:\UVG\System Security>openssl enc -aes-256-cbc -d -in mensaje_cifrado.bin -out mensaje_descifrado.txt -pass file:aes_key_descifrada.txt
*** WARNING : deprecated key derivation used.
Using -iter or -pbkdf2 would be better.

D:\UVG\System Security>openssl dgst -sha256 -out mensaje.hash mensaje.txt
mensaje.txt: No such file or directory

D:\UVG\System Security>openssl dgst -sha256 -out mensaje.hash mensaje.txt

D:\UVG\System Security>openssl dgst -sha256 -sign rsa_privada.pem -out firma.bin mensaje.txt

D:\UVG\System Security>openssl dgst -sha256 -verify clave_publica_remitente.pem -signature firma.bi
Can't open clave_publica_remitente.pem for reading, No such file or directory
25368:error:02001002:system library:fopen:No such file or directory:../openssl-1.1.1s/crypto/bio/bss_file.c:69:fopen('clave_publica_remitente.pem','r')
25368:error:2006D080:BIO routines:BIO_new_file:no such file:../openssl-1.1.1s/crypto/bio/bss_file.c:76:
unable to load key file

D:\UVG\System Security>openssl dgst -sha256 -verify rsa_publica.pem -signature firma.bin mensaje.txt
Verified OK

D:\UVG\System Security>openssl req -x509 -newkey rsa:2048 -keyout mi_certificado.key -out mi_certificado.crt -days 365 -nodes
Generating a RSA private key
.............................+++++
..................................+++++
writing new private key to 'mi_certificado.key'
-----
You are about to be asked to enter information that will be incorporated
into your certificate request.
What you are about to enter is what is called a Distinguished Name or a DN.
There are quite a few fields but you can leave some blank
For some fields there will be a default value,
If you enter '.', the field will be left blank.
-----
Country Name (2 letter code) [AU]:GU
State or Province Name (full name) [Some-State]:Guatemala
Locality Name (eg, city) []:Guatemala
Organization Name (eg, company) [Internet Widgits Pty Ltd]:Peko Ltd
Organizational Unit Name (eg, section) []:ISIS
Common Name (e.g. server FQDN or YOUR name) []:PEKOPEKO
Email Address []:quete@gmail.com

D:\UVG\System Security> 